11111111111111
10000000001001
10000100100001
10000000N10001
10010000000001
10000100010001
10010000000001
11111111111111
